1111111111111111111111111111111111
100000N00000001C10000C00000E000001
1010010100100010101001000000010101
10100100101010100N1001000000010101
1P0000000C00C0000000000N00000000C1
100000N00000001C10000C000000000001
1010010100100010101001000000010101
10100100101010100N1001000000010101
100000000C00C0000000000N00000000C1
1010010100100010101001000000101011
10100100101010100N1001000000010101
100000000C00C0000000000N00000000C1
1111111111111111111111111111111111