1111111111111111111111111
1P00000100000000N00C00001
1110101010111111011101111
1C00000000000100000001001
1011101110101011101110101
1000000000100010000000001
1011111111110111110111111
1000000C000000C0000000001
1000000C000000C0000000001
1011101111111111111101111
1C000100000000000000000E1
1111111111111111111111111