1111111111111111111111111111111111
100000000000001C10000C000000000001
101001010010001E101001000000010101
1010010010101010001001000000010101
1P0000000C00C0000000000000000000C1
1000000C00C0000000000000000000C001
1000000C00C0000000000000000000C001
1000000C00C0000000000000000000C001
1000000C00C0000000000000000000C001
1000000C00C0000000000000000000C001
100000000000001C10000C000000000001
1010010100100011101001000000010101
1010010010101010001001000000010101
110000000C00C0000000000000000000C1
1000000C00C0000000000000000000C001
1000000C00C0000000000000000000C001
1000000C00C0000000000000000000C001
1000000C00C0000000000000000000C001
1000000C00C0000000000000000000C001
1111111111111111111111111111111111