11111111111111111111
1P00000000N00000000E
11110111111111110111
1C0010000010000100N1
10110101110101011101
10000001000000000001
10111111011101111101
1N0000000C0000000001
11111111111111111111
